#################################################################
#...............................................................#
#...............................................................#
#...............................................................#
#...............................................................#
#...............................................................#
#...............................................................#
#...............................................................#
#...............................................................#
#...............................................................#
#...................................#############################
#...................................#############################
#...................................#############################
#...............................................................#
#...............................................................#
#...............................................................#
#...............................................................#
#...............................................................#
#...............................................................#
#..............................................+................#
#...............................................................#
#...............................................................#
#...............................................................#
#...............................................................#
#...............................................................#
#...............................................................#
#...............................................................#
###############.......################....#######################
#.............#.......#..............#....#.....................#
#.............#.......#..............#....#.....................#
#.............#.......#..............#....#.....................#
#.............#.......#..............#....#.....................#
#.............#.......#..............#....#.....................#
#.............#.......#..............#....#.....................#
#.............#.......#..............#....#.....................#
#.............#.......#..............#....#.....................#
#.............#.......#..............#....#.....................#
#.............#.......#..............#....#.....................#
#.............#.......#..............#....#.....................#
#.............#.......#..............#....#.....................#
#.............#.......#..............#....#.....................#
#.............#.......#..............#....#.....................#
#.............#.......#..............#....#.....................#
#.............#.......#..............#....#.....................#
#.............#.......#..............#....#.....................#
#.............#.......#..............#....#.....................#
#.............#.......#..............#....#.....................#
#.............#.......#..............#....#.....................#
#.............#.......#..............#....#.....................#
#.............#.......#..............#....#.....................#
#.............#.......#..............#....#.....................#
#.............#.......#..............#....#.....................#
#.............#.......#..............#....#.....................#
#.............#.......#..............#....#.....................#
#.............#.......#..............#....#.....................#
#.............#.......#..............#....#.....................#
#.............#.......#..............#....#.....................#
#.............#.......#..............#....#.....................#
###############.......#..............#....#.....................#
#.....................#..............#....#.....................#
#.....................#..............#....#.....................#
#....##################..............#....#.....................#
#....#...............................#....#.....................#
#....#...............................#....#.....................#
#....#...............................#....#.....................#
#....#...............................#.+..#.....................#
#....#...............................#....#.....................#
#....############################################################
#...............................................................#
#...............................................................#
#...............................................................#
#...............................................................#
#...............................................................#
#...............................................................#
#...............................................................#
#...............................................................#
#...............................................................#
#...............................................................#
#...............................................................#
#...............................................................#
#...............................................................#
#...............................................................#
#...............................................................#
#...............................................................#
#...............................................................#
#...............................................................#
#..................#################............................#
#..................#################............................#
#..................#################............................#
#..................#################............................#
#..................#################............................#
#..................#################............................#
#..................#################............................#
#..................#################............................#
#..................#################............................#
#..................#################.......+....................#
#..................#################............................#
#..................#################............................#
#..................#################............................#
#..................#################............................#
#..................#################............................#
#..................#################............................#
#..................#################............................#
#..................#################............................#
#..................#################............................#
#..................#################............................#
#..................#################............................#
#..................#################............................#
#..................#################............................#
#..................#################............................#
#..................#################............................#
#..................#################............................#
#..................#################............................#
#..................#################............................#
#..................#################............................#
#..................#################............................#
#..................#################............................#
#\.................#################............................#
##\.............../#################............................#
###\............./##################............................#
####\.........../###################............................#
#####\........./####################............................#
######\......./#####################..................+.........#
#######\...../######################............................#
########\.../#######################............................#
#........\./.......#################............................#
#..................#################............................#
#..................#################............................#
#..................#################............................#
#..................#################............................#
#..................#################.........+..................#
#..................#################............................#
#..................#################............................#
#..................#################............................#
#..................#################............................#
#........*.........#################......................+.....#
#..................#################............................#
#..................#################............................#
#################################################################